11111111111
10000000001
10C10001C01
10110001101
10000000001
10000E00001
10000000001
10110001101
10C10001C01
10000P00001
11111111111