111111111111111111111
100C000000C000000C001
111111111111111111101
10000000000000000C1P1
101111101111101011101
10000E1000C0001C00001
111111111111111111111