111111111111111111111111111111
100000000000000000000000000011
100000000000000000000000000011
100000000000000000000000000011
100000000000000000000000000011
100000000000000000000000000011
100000000000000000000000000011
100000000000000000000000000011
100000000000000000000000000011
100000000000000000000000000011
100000000000000000000000000011
100000000000000000000000000011
100000000000000000000000000011
100000000000000000000ECP000011
111111111111111111111111111111
111111111111111111111111111111