11111111111
10000000001
10C10X01C01
10110001101
10000000001
10X00E00X01
10000000001
10110X01101
10C10001C01
10000P00001
11111111111